-----------Инструкция пользования программой-----------

1. Запустить файл Auto_ru.exe.
2. Указать с какой страницы начинаем парсинг (если нужно все, то указываем 1)
3. Указать путь создания файла с полученными данными (например C:\Users\<Ваша рабочая папка>\Desktop или любой другой)
4. Создать пустой Excel документ, открыть его.
5. Во вкладке "Данные" выбрать "Получить данные" -> "Из текстового файла/CSV-файла". Выбрать файл, который был создан программой Auto_ru.exe по указанному Вами адресу.
6. Изменить кодировку источника файла на Юникод(UTF-8). (Есть такая опция).
7. В качестве разделителя указать пользовательский вариант. В появившемся окошке для ввода указать в качестве разделителя @ - без скобок и кавычек.
8. Данные получены и систематизированы.



ПОЯСНЕНИЕ:

КОЛОНКА A - телефон продавца
КОЛОНКА B - наименование продавца
КОЛОНКА С - стоимость в RUR
КОЛОНКА D - в EUR
КОЛОНКА E - в USD
КОЛОНКА F - url фото товара
КОЛОНКА G - марка
КОЛОНКА H - растаможка
КОЛОНКА I - год выпуска
КОЛОНКА J - тип продавца (частный, коммерч.)
КОЛОНКА K - город
КОЛОНКА L - г/п, мощность 
КОЛОНКА M - кол-во владельцев
КОЛОНКА N - VIN
КОЛОНКА O - ПТС
КОЛОНКА P - категория грузовика
КОЛОНКА Q - тип грузовика 
КОЛОНКА R - тип двигателя
КОЛОНКА S - трансмиссия
КОЛОНКА T - руль
КОЛОНКА U - дата создания объявления
КОЛОНКА V - дата последнего обновления объевляния

ПОДДЕРЖКА: 

Готов оказать бесплатную поддержку в течение месяца + бесплатно выслать версию программы с новыми параметрами поиска.

Мои контакты:
email: avkouzbar.dev@gmail.com
telegram: @avkouzbar_dev  
